111111111
10E000001
100P00001
1C0000001
111111111