1111111111111
10110000000C1
1P10011111001
1C0000E000001
1011110000C01
1000C00000001
1111111111111


