1111111111111
10C1000000PC1
1000011111001
1C0011E000001
1111111111111