111111111
1P0001111
1C1000E11
111111111